"filename", "language", "TOML", "Rust", "Markdown", "comment", "blank", "total"
"/Users/guyuesheng/Development/Projects/nodejs_project/web-ssh-tool/rust/Cargo.lock", "TOML", 2272, 0, 0, 2, 257, 2531
"/Users/guyuesheng/Development/Projects/nodejs_project/web-ssh-tool/rust/Cargo.toml", "TOML", 34, 0, 0, 1, 3, 38
"/Users/guyuesheng/Development/Projects/nodejs_project/web-ssh-tool/rust/src/app_config.rs", "Rust", 0, 149, 0, 9, 19, 177
"/Users/guyuesheng/Development/Projects/nodejs_project/web-ssh-tool/rust/src/connection_peer.rs", "Rust", 0, 151, 0, 0, 23, 174
"/Users/guyuesheng/Development/Projects/nodejs_project/web-ssh-tool/rust/src/http_server/client.rs", "Rust", 0, 29, 0, 0, 2, 31
"/Users/guyuesheng/Development/Projects/nodejs_project/web-ssh-tool/rust/src/http_server/download.rs", "Rust", 0, 89, 0, 0, 3, 92
"/Users/guyuesheng/Development/Projects/nodejs_project/web-ssh-tool/rust/src/http_server/file_send.rs", "Rust", 0, 15, 0, 0, 2, 17
"/Users/guyuesheng/Development/Projects/nodejs_project/web-ssh-tool/rust/src/http_server/helpers.rs", "Rust", 0, 29, 0, 0, 2, 31
"/Users/guyuesheng/Development/Projects/nodejs_project/web-ssh-tool/rust/src/http_server/mod.rs", "Rust", 0, 77, 0, 1, 6, 84
"/Users/guyuesheng/Development/Projects/nodejs_project/web-ssh-tool/rust/src/http_server/not_found.rs", "Rust", 0, 16, 0, 0, 4, 20
"/Users/guyuesheng/Development/Projects/nodejs_project/web-ssh-tool/rust/src/http_server/upload.rs", "Rust", 0, 76, 0, 0, 3, 79
"/Users/guyuesheng/Development/Projects/nodejs_project/web-ssh-tool/rust/src/main.rs", "Rust", 0, 175, 0, 2, 9, 186
"/Users/guyuesheng/Development/Projects/nodejs_project/web-ssh-tool/rust/src/tls/mod.rs", "Rust", 0, 28, 0, 0, 5, 33
"/Users/guyuesheng/Development/Projects/nodejs_project/web-ssh-tool/rust/src/tls/readme.md", "Markdown", 0, 0, 5, 0, 2, 7
"/Users/guyuesheng/Development/Projects/nodejs_project/web-ssh-tool/rust/src/websocket_client/components.rs", "Rust", 0, 128, 0, 0, 17, 145
"/Users/guyuesheng/Development/Projects/nodejs_project/web-ssh-tool/rust/src/websocket_client/download.rs", "Rust", 0, 253, 0, 7, 15, 275
"/Users/guyuesheng/Development/Projects/nodejs_project/web-ssh-tool/rust/src/websocket_client/mod.rs", "Rust", 0, 275, 0, 0, 13, 288
"/Users/guyuesheng/Development/Projects/nodejs_project/web-ssh-tool/rust/src/websocket_client/upload.rs", "Rust", 0, 56, 0, 0, 3, 59
"/Users/guyuesheng/Development/Projects/nodejs_project/web-ssh-tool/rust/src/websocket_client/watch.rs", "Rust", 0, 341, 0, 2, 23, 366
"/Users/guyuesheng/Development/Projects/nodejs_project/web-ssh-tool/rust/src/websocket_server/mod.rs", "Rust", 0, 48, 0, 0, 2, 50
"/Users/guyuesheng/Development/Projects/nodejs_project/web-ssh-tool/rust/src/websocket_server/on_authenticate.rs", "Rust", 0, 145, 0, 1, 11, 157
"/Users/guyuesheng/Development/Projects/nodejs_project/web-ssh-tool/rust/src/websocket_server/on_client.rs", "Rust", 0, 73, 0, 0, 7, 80
"/Users/guyuesheng/Development/Projects/nodejs_project/web-ssh-tool/rust/src/websocket_server/on_request_authenticate.rs", "Rust", 0, 173, 0, 0, 12, 185
"/Users/guyuesheng/Development/Projects/nodejs_project/web-ssh-tool/rust/src/websocket_server/shell.rs", "Rust", 0, 150, 0, 0, 11, 161
"Total", "-", 2306, 2476, 5, 25, 454, 5266